1111111111111111111111111111111111
1011000000000000100000000000000001
1000C00110000000000000000011111101
1000000110000011111111000000000101
1110000000000000000000000000000101
1010000000000000000000000000C00101
1000001100000011P11000000001111101
1000000000000010E01000000000000101
110000C000000011111000001100000101
1000000000000000000000001100000101
1000111100000000000000000000001101
1000000000000000000000000000000101
11000000000010000000000000000001C1
1100000000001C00001000001000000111
1111111111111111111111111111111111