1111111111111111111111111111111111
1E1000000000000C00000C000000000001
1010010100100000101001000000010101
1000010010101010001010000000010101
1000010010101010001010000000010101
1000010010101010001010000000010101
1000010010101010001010000000010101
1000010010101010001010000000010101
1000010010101010001010000000010101
1000010010101010001010000000010101
1000010010101010001010000000010101
1P1000000C00C0000000000000000001C1
1111111111111111111111111111111111