1111111111111111111111111111111111
1111111111111111111111111111111111
1110010100100000101001000000011111
1110010010101010001010000000010111
110000000C00C000000000000000000111
1111111111111111111111111111111111