1111111111111111111111111111111111
1010000000000000000001000000000001
1010010100100000101001000000010101
1000010010101010001010000000010101
1000010010101010001010000000010101
1000010010101010001010000000010101
1000010010101010001010000000010101
1E00010010101010001010000000010101
1000010010101010001010000000010101
1C00010010101010001010000000010101
1000010010101010001010000000010101
1000010010101010001010000000010101
1000010010101010001010000000010101
1P10000000000000000000000000000111
1111111111111111111111111111111111