1111
1001
10E1
1001
1001
1001
1C01
1001
1001
10P1
1111